"a" = (/obj/structure/tree,/turf/floor/grass,/area)
"b" = (/turf/floor/grass,/area)
"c" = (/turf/floor/rock,/area)
"d" = (/obj/machinery/elevator_control,/turf/floor/rock,/area)
"e" = (/obj/structure/platform,/turf/floor/rock,/area/elevator)
"f" = (/obj/machinery/conveyor,/turf/floor/rock,/area)
"g" = (/obj/machinery/conveyor/east/south,/turf/floor/rock,/area)
"h" = (/obj/machinery/conveyor{dir = 8},/turf/floor/rock,/area)
"i" = (/obj/machinery/conveyor{dir = 8},/obj/machinery/drill,/turf/floor/rock,/area)
"j" = (/obj/machinery/drill_control,/turf/floor/rock,/area)
"k" = (/obj/machinery/conveyor{dir = 1},/turf/floor/rock,/area)
"l" = (/obj/structure/multiz/ladder/down,/turf/floor/rock,/area)
"m" = (/obj/machinery/conveyor/north/east,/turf/floor/rock,/area)
"n" = (/obj/machinery/conveyor{dir = 4},/obj/machinery/saw,/turf/floor/rock,/area)
"o" = (/obj/machinery/conveyor{dir = 4},/turf/floor/rock,/area)
"p" = (/obj/machinery/conveyor/west/north,/turf/floor/rock,/area)
"q" = (/obj/structure/workbench/carpentry,/turf/floor/grass,/area)
"r" = (/obj/machinery/conveyor/north/west,/turf/floor/rock,/area)
"s" = (/obj/item/weapon/axe,/turf/floor/grass,/area)
"t" = (/turf/wall/rock,/area)
"u" = (/obj/machinery/conveyor/east/south,/turf/floor/grass,/area)
"v" = (/obj/machinery/conveyor{dir = 8},/turf/floor/grass,/area)
"w" = (/obj/machinery/conveyor/north/west,/turf/floor/grass,/area)
"x" = (/obj/machinery/conveyor{dir = 8},/obj/item/wood,/turf/floor/rock,/area)
"y" = (/obj/machinery/conveyor/south/west,/turf/floor/rock,/area)
"z" = (/obj/machinery/conveyor,/obj/machinery/furnace,/turf/floor/rock,/area)
"A" = (/obj/machinery/conveyor,/obj/item/wood,/turf/floor/rock,/area)
"B" = (/obj/machinery/conveyor/south/west,/obj/item/planks,/turf/floor/rock,/area)
"C" = (/obj/item/weapon/pickaxe,/turf/floor/rock,/area)
"D" = (/obj/machinery/conveyor,/obj/item/planks,/turf/floor/rock,/area)
"E" = (/turf/floor/spawnpoint,/area)
"F" = (/obj/item/clothing/head/hardhat,/turf/floor/grass,/area)
"G" = (/obj/item/clothing/uniform/workman,/turf/floor/grass,/area)
"H" = (/obj/machinery/conveyor{dir = 4},/obj/item/planks,/turf/floor/rock,/area)
"I" = (/obj/machinery/conveyor{dir = 1},/obj/item/wood,/turf/floor/rock,/area)
"J" = (/obj/item/clothing/shoes/rubberboots,/turf/floor/grass,/area)
"K" = (/obj/machinery/conveyor{dir = 4},/obj/item/wood,/turf/floor/rock,/area)
"L" = (/obj/machinery/buy,/turf/wall/rock,/area)
"M" = (/obj/machinery/budgetdisplay,/turf/wall/rock,/area)
"N" = (/obj/machinery/sell,/turf/wall/rock,/area)
"O" = (/obj/machinery/elevator_control/bottom,/turf/floor/rock,/area)
"P" = (/turf/floor/rock,/area/elevator)
"Q" = (/obj/structure/closet,/turf/floor/rock,/area)
"R" = (/obj/structure/multiz/ladder/up,/turf/floor/rock,/area)
"S" = (/obj/machinery/budgetdisplay,/turf/floor/rock,/area)

(1,1,1) = {"
abbbbbbbbbbbbbbbbbbbbbbbbbbbbbbbbabbbbbbbbbbbbbbbb
bbbbabbbbbbbabbbbbbbabbbbbabbbbbbbbbbabbbbbbbabbbb
bbabbbbbbbbbbbbbbbbbbbbbbbbbbbbbbbbabbbbbbbbbbbbbb
bbbbbbbbbbbbbbbbbbbbbbbbbbbbbbabbbbbbbbbbbbbbbbbbb
bbbbbbbbabbbbbbbbabbbbbbbbbbbbbbbbbbbbbbbabbbbbbbb
bbbabbbbbbbbbabbbbbbbbbabbbbbbbbbbbbabbbbbbbbbabbb
bbbbbbbbbbbbbbbabbbbbbbbbbbbbbbbbbbbbbbbbbbbbbbbab
abbbbbabbababbbbbbabbbbabbbbbabbbabbbbbabbababbbbb
bbbbbbbbbbbbbbbbbbbbbbbbbbbbbbabbbbbbbbbbbbbbbbbbb
bbabbbbbabbbbbbbbbbbbbbbbbbbbbbbbbbabbbbbabbbbbbbb
bbbbbbbbbbbbbabbbbabbbbbabbbbbbbbbbbbbbbbbbbbbabbb
bbbbbabbbbbbbbbbbbbbbbbbbbbbbbbbbbbbbbabbbbbbbbbbb
bbbbabbbabbbbbbbbbbbbbabbbbbbbbbbbbbbabbbabbbbbbbb
abbbbbbbbbbbbbbbbabbbbbbbbbbbbbbbabbbbbbbbbbbbbbbb
bbbbbbbbbbbbbbbbbbbbbbbbbbbbbbbbbbbbbbbbbbbbbbbbbb
bbbbbbbabbbbabbbbbbbbbbbabbbbbbbabbbbbabbabbbbbbbb
bbbbbbbbbbbbbbbbbabbbabbbbbbbbbbbbbbbbbbbbbbbbabbb
bbbbbabbbbbbbbbbbbbbbbbbbbbbbbbbbbbbbbabbbbbabbbbb
bbbabbbbbbbabbabbbbbbbbabbbbbabbbbbabbbbbbbbbbabbb
bbbbbbbbbbbbbbbbbbbabbbbbbabbbbbbbbbbbbbbabbbbbbbb
bbbbbbbbbbbabbbbbabbbbbbbbbbbbbbabbbbbabbbbabbbbbb
bbbbbbbbabbbbbbbbbbabbbbabbbbabbbbbabbbbbbabbbbabb
bbabbbbbbbbbbbabbbbbbbbbbbbbbbbbbbbbbbbbbbbbbbbbbb
bbbbabbbbbbabbbbabbbbbbbbbbbbabbbbbbbbbbabbabbbbbb
bbabbbbbabbbbbbabbbbabbbbbbabbbbbbabbbbbbbbbbbbabb
bbbbbbbbbbbbbbbbbbbbbbbbabbbbbbbabbbbbbabbbbbbbbba
bbbbabbbbbbbbabbabbbbbbbbbbbabbbbabbbbbbbbabbbbbbb
bbbbbbbabbbbbbbbbbbbabbbbbbbbbabbbbbbabbbbbbbabbbb
babbbbbbbbbbabbbbbbbbbabbcbcbbbbbbbbbbbbbabbbbbbab
bbbbbbabbbbbbbbabbbbbbbbcccccbbbbbbbbabbbbbbabbbbb
bbbbbbbbbbabbbbbbbabbbbbcccdccbabbbbbbabbbbbbbbbbb
bbbbabbbbbbbbbabbbbbbabccceeeccbbbbbabbbbbbbabbabb
bbbbbbbbbbabbbbbbabbbccccceeecbbbbbbbbbbbbbbbbbbbb
bbbbbbbbbbbbbbbabbbbbccccceeecbccbbcbbbbbbbbabbbbb
abbbbbbabbbbbbbbbbbbcccccccccccccccccbbbbabbbbbbbb
bbbabbbbbbbbabbbbabcccccccccccfccccbbbbbbbbbbbbabb
bbbbbbabbbbbbbbbbbbbghhijcccccfcckcbbabbbbbbabbbba
bbbbbbbbbbabbbbbabbbfcccccclccmnopcbbbbbbabbbbbbab
bbbbbabbbbbbqbbbbbbgrcccccccccccccccbbbbbbbbbbbbbb
bbbbbbbbbbsbbbbbbbbftttttttttttttttcbabbbbbbbbabba
babbbbabbbbbbbabbuvwtttttttttttttttbbbbbabbbbbbbbb
bbbbbbbbbbttttbbtftttttttttttttttttbbbbbbbbbbabbbb
bbbbbbbbbbtcctbbtfccghhxyttttttttttbbbbabbbbbbbbab
bbbbbbbbbbtcctbbtzccAghBkttttttttttbbbbbbbbabbbbbb
bbbbbbbbbbccctbbtfcCfDckkttttttttttbbabbbbbbbbbabb
bbbEbbbbbFtccttttcccffckkttttttttttbbbbbbbbabbbbbb
bbbbbbbbbGtcccccccccfmHpIttttttttttbbbbbbbbbbbbbab
bbbbbbbbbJttccccccccmKoopttttttttttbbbbbabbbbbbbbb
bbbbbbbbbbbtttttLMNttttttttttttttttbbbbbbbbbbbabbb
bbbbbbbbbbbbbbbbbbbbtttttttttttttttbbabbbbbbbbbbbb
"}

(1,1,2) = {"
tttttttttttttttttttttttttttttttttttttttttttttttttt
tttttttttttttttttttttttttttttttttttttttttttttttttt
tttttttttttttttttttttttttttttttttttttttttttttttttt
tttttttttttttttttttttttttttttttttttttttttttttttttt
tttttttttttttttttttttttttttttttttttttttttttttttttt
tttttttttttttttttttttttttttttttttttttttttttttttttt
tttttttttttttttttttttttttttttttttttttttttttttttttt
tttttttttttttttttttttttttttttttttttttttttttttttttt
tttttttttttttttttttttttttttttttttttttttttttttttttt
tttttttttttttttttttttttttttttttttttttttttttttttttt
tttttttttttttttttttttttttttttttttttttttttttttttttt
tttttttttttttttttttttttttttttttttttttttttttttttttt
tttttttttttttttttttttttttttttttttttttttttttttttttt
tttttttttttttttttttttttttttttttttttttttttttttttttt
tttttttttttttttttttttttttttttttttttttttttttttttttt
tttttttttttttttttttttttttttttttttttttttttttttttttt
tttttttttttttttttttttttttttttttttttttttttttttttttt
tttttttttttttttttttttttttttttttttttttttttttttttttt
tttttttttttttttttttttttttttttttttttttttttttttttttt
tttttttttttttttttttttttttttttttttttttttttttttttttt
tttttttttttttttttttttttttttttttttttttttttttttttttt
tttttttttttttttttttttttttttttttttttttttttttttttttt
tttttttttttttttttttttttttttttttttttttttttttttttttt
tttttttttttttttttttttttttttttttttttttttttttttttttt
tttttttttttttttttttttttttttttttttttttttttttttttttt
tttttttttttttttttttttttttttttttttttttttttttttttttt
tttttttttttttttttttttttttttttttttttttttttttttttttt
tttttttttttttttttttttttttttttttttttttttttttttttttt
tttttttttttttttttttttttttccccctttttttttttttttttttt
tttttttttttttttttttttttttccccctttttttttttttttttttt
tttttttttttttttttttttttttccOcctttttttttttttttttttt
tttttttttttttttttttttttttcPPPctttttttttttttttttttt
tttttttttttttttttttttttttcPPPctttttttttttttttttttt
tttttttttttttttttttttttttcPPPctttttttttttttttttttt
tttttttttttttttttttttttttccccctttttttttttttttttttt
tttttttttttttttttttttttttcQQQctttttttttttttttttttt
tttttttttttttttttttttttttccccftttttttttttttttttttt
tttttttttttttttttttttttttccRcftttttttttttttttttttt
tttttttttttttttttttttttttCcccztttttttttttttttttttt
tttttttttttttttttttttttttcclcftttttttttttttttttttt
tttttttttttttttttttttttttccScctttttttttttttttttttt
tttttttttttttttttttttttttttttttttttttttttttttttttt
tttttttttttttttttttttttttttttttttttttttttttttttttt
tttttttttttttttttttttttttttttttttttttttttttttttttt
tttttttttttttttttttttttttttttttttttttttttttttttttt
tttttttttttttttttttttttttttttttttttttttttttttttttt
tttttttttttttttttttttttttttttttttttttttttttttttttt
tttttttttttttttttttttttttttttttttttttttttttttttttt
tttttttttttttttttttttttttttttttttttttttttttttttttt
tttttttttttttttttttttttttttttttttttttttttttttttttt
"}

(1,1,3) = {"
tttttttttttttttttttttttttttttttttttttttttttttttttt
tttttttttttttttttttttttttttttttttttttttttttttttttt
tttttttttttttttttttttttttttttttttttttttttttttttttt
tttttttttttttttttttttttttttttttttttttttttttttttttt
tttttttttttttttttttttttttttttttttttttttttttttttttt
tttttttttttttttttttttttttttttttttttttttttttttttttt
tttttttttttttttttttttttttttttttttttttttttttttttttt
tttttttttttttttttttttttttttttttttttttttttttttttttt
tttttttttttttttttttttttttttttttttttttttttttttttttt
tttttttttttttttttttttttttttttttttttttttttttttttttt
tttttttttttttttttttttttttttttttttttttttttttttttttt
tttttttttttttttttttttttttttttttttttttttttttttttttt
tttttttttttttttttttttttttttttttttttttttttttttttttt
tttttttttttttttttttttttttttttttttttttttttttttttttt
tttttttttttttttttttttttttttttttttttttttttttttttttt
tttttttttttttttttttttttttttttttttttttttttttttttttt
tttttttttttttttttttttttttttttttttttttttttttttttttt
tttttttttttttttttttttttttttttttttttttttttttttttttt
tttttttttttttttttttttttttttttttttttttttttttttttttt
tttttttttttttttttttttttttttttttttttttttttttttttttt
tttttttttttttttttttttttttttttttttttttttttttttttttt
tttttttttttttttttttttttttttttttttttttttttttttttttt
tttttttttttttttttttttttttttttttttttttttttttttttttt
tttttttttttttttttttttttttttttttttttttttttttttttttt
tttttttttttttttttttttttttttttttttttttttttttttttttt
tttttttttttttttttttttttttttttttttttttttttttttttttt
tttttttttttttttttttttttttttttttttttttttttttttttttt
tttttttttttttttttttttttttttttttttttttttttttttttttt
tttttttttttttttttttttttttttttttttttttttttttttttttt
tttttttttttttttttttttttttttttttttttttttttttttttttt
tttttttttttttttttttttttttttttttttttttttttttttttttt
tttttttttttttttttttttttttttttttttttttttttttttttttt
tttttttttttttttttttttttttttttttttttttttttttttttttt
tttttttttttttttttttttttttttttttttttttttttttttttttt
tttttttttttttttttttttttttttttttttttttttttttttttttt
tttttttttttttttttttttttttccccctttttttttttttttttttt
tttttttttttttttttttttttttccccctttttttttttttttttttt
tttttttttttttttttttttttttccccctttttttttttttttttttt
tttttttttttttttttttttttttccccctttttttttttttttttttt
tttttttttttttttttttttttttccRcctttttttttttttttttttt
tttttttttttttttttttttttttccccctttttttttttttttttttt
tttttttttttttttttttttttttttttttttttttttttttttttttt
tttttttttttttttttttttttttttttttttttttttttttttttttt
tttttttttttttttttttttttttttttttttttttttttttttttttt
tttttttttttttttttttttttttttttttttttttttttttttttttt
tttttttttttttttttttttttttttttttttttttttttttttttttt
tttttttttttttttttttttttttttttttttttttttttttttttttt
tttttttttttttttttttttttttttttttttttttttttttttttttt
tttttttttttttttttttttttttttttttttttttttttttttttttt
tttttttttttttttttttttttttttttttttttttttttttttttttt
"}
