"a" = (/obj/structure/tree,/turf/floor/grass,/area)
"b" = (/turf/floor/grass,/area)
"c" = (/turf/floor/rock,/area)
"d" = (/obj/machinery/elevator_control,/turf/floor/rock,/area)
"e" = (/obj/structure/platform,/turf/floor/rock,/area/elevator)
"f" = (/obj/machinery/conveyor,/turf/floor/rock,/area)
"g" = (/obj/machinery/conveyor/east/south,/turf/floor/rock,/area)
"h" = (/obj/machinery/conveyor{dir = 8},/turf/floor/rock,/area)
"i" = (/obj/machinery/conveyor{dir = 8},/obj/machinery/drill,/turf/floor/rock,/area)
"j" = (/obj/machinery/drill_control,/turf/floor/rock,/area)
"k" = (/obj/machinery/conveyor{dir = 1},/turf/floor/rock,/area)
"l" = (/obj/structure/multiz/ladder/down,/turf/floor/rock,/area)
"m" = (/obj/machinery/conveyor/north/east,/turf/floor/rock,/area)
"n" = (/obj/machinery/conveyor{dir = 4},/obj/machinery/saw,/turf/floor/rock,/area)
"o" = (/obj/machinery/conveyor{dir = 4},/turf/floor/rock,/area)
"p" = (/obj/machinery/conveyor/west/north,/turf/floor/rock,/area)
"q" = (/obj/structure/workbench/carpentry,/turf/floor/grass,/area)
"r" = (/obj/machinery/conveyor/north/west,/turf/floor/rock,/area)
"s" = (/turf/floor/openspace,/area)
"t" = (/obj/item/weapon/axe,/turf/floor/grass,/area)
"u" = (/turf/wall/rock,/area)
"v" = (/obj/machinery/conveyor/east/south,/turf/floor/grass,/area)
"w" = (/obj/machinery/conveyor{dir = 8},/turf/floor/grass,/area)
"x" = (/obj/machinery/conveyor/north/west,/turf/floor/grass,/area)
"y" = (/obj/structure/cashbox,/turf/floor/rock,/area)
"z" = (/obj/machinery/conveyor{dir = 8},/obj/item/wood,/turf/floor/rock,/area)
"A" = (/obj/machinery/conveyor/south/west,/turf/floor/rock,/area)
"B" = (/obj/machinery/conveyor,/obj/machinery/furnace,/turf/floor/rock,/area)
"C" = (/obj/machinery/conveyor,/obj/item/wood,/turf/floor/rock,/area)
"D" = (/obj/machinery/conveyor/south/west,/obj/item/planks,/turf/floor/rock,/area)
"E" = (/obj/item/weapon/pickaxe,/turf/floor/rock,/area)
"F" = (/obj/machinery/conveyor,/obj/item/planks,/turf/floor/rock,/area)
"G" = (/turf/floor/spawnpoint,/area)
"H" = (/obj/item/clothing/head/hardhat,/turf/floor/grass,/area)
"I" = (/obj/item/clothing/uniform/workman,/turf/floor/grass,/area)
"J" = (/obj/machinery/conveyor{dir = 4},/obj/item/planks,/turf/floor/rock,/area)
"K" = (/obj/machinery/conveyor{dir = 1},/obj/item/wood,/turf/floor/rock,/area)
"L" = (/obj/item/clothing/shoes/rubberboots,/turf/floor/grass,/area)
"M" = (/obj/machinery/conveyor{dir = 4},/obj/item/wood,/turf/floor/rock,/area)
"N" = (/obj/machinery/buy,/turf/wall/rock,/area)
"O" = (/obj/machinery/budgetdisplay,/turf/wall/rock,/area)
"P" = (/obj/machinery/sell,/turf/wall/rock,/area)
"Q" = (/obj/machinery/elevator_control/bottom,/turf/floor/rock,/area)
"R" = (/turf/floor/rock,/area/elevator)
"S" = (/obj/structure/closet,/turf/floor/rock,/area)
"T" = (/obj/structure/multiz/ladder/up,/turf/floor/rock,/area)
"U" = (/obj/machinery/budgetdisplay,/turf/floor/rock,/area)

(1,1,1) = {"
abbbbbbbbbbbbbbbbbbbbbbbbbbbbbbbbabbbbbbbbbbbbbbbb
bbbbabbbbbbbabbbbbbbabbbbbabbbbbbbbbbabbbbbbbabbbb
bbabbbbbbbbbbbbbbbbbbbbbbbbbbbbbbbbabbbbbbbbbbbbbb
bbbbbbbbbbbbbbbbbbbbbbbbbbbbbbabbbbbbbbbbbbbbbbbbb
bbbbbbbbabbbbbbbbabbbbbbbbbbbbbbbbbbbbbbbabbbbbbbb
bbbabbbbbbbbbabbbbbbbbbabbbbbbbbbbbbabbbbbbbbbabbb
bbbbbbbbbbbbbbbabbbbbbbbbbbbbbbbbbbbbbbbbbbbbbbbab
abbbbbabbababbbbbbabbbbabbbbbabbbabbbbbabbababbbbb
bbbbbbbbbbbbbbbbbbbbbbbbbbbbbbabbbbbbbbbbbbbbbbbbb
bbabbbbbabbbbbbbbbbbbbbbbbbbbbbbbbbabbbbbabbbbbbbb
bbbbbbbbbbbbbabbbbabbbbbabbbbbbbbbbbbbbbbbbbbbabbb
bbbbbabbbbbbbbbbbbbbbbbbbbbbbbbbbbbbbbabbbbbbbbbbb
bbbbabbbabbbbbbbbbbbbbabbbbbbbbbbbbbbabbbabbbbbbbb
abbbbbbbbbbbbbbbbabbbbbbbbbbbbbbbabbbbbbbbbbbbbbbb
bbbbbbbbbbbbbbbbbbbbbbbbbbbbbbbbbbbbbbbbbbbbbbbbbb
bbbbbbbabbbbabbbbbbbbbbbabbbbbbbabbbbbabbabbbbbbbb
bbbbbbbbbbbbbbbbbabbbabbbbbbbbbbbbbbbbbbbbbbbbabbb
bbbbbabbbbbbbbbbbbbbbbbbbbbbbbbbbbbbbbabbbbbabbbbb
bbbabbbbbbbabbabbbbbbbbabbbbbabbbbbabbbbbbbbbbabbb
bbbbbbbbbbbbbbbbbbbabbbbbbabbbbbbbbbbbbbbabbbbbbbb
bbbbbbbbbbbabbbbbabbbbbbbbbbbbbbabbbbbabbbbabbbbbb
bbbbbbbbabbbbbbbbbbabbbbabbbbabbbbbabbbbbbabbbbabb
bbabbbbbbbbbbbabbbbbbbbbbbbbbbbbbbbbbbbbbbbbbbbbbb
bbbbabbbbbbabbbbabbbbbbbbbbbbabbbbbbbbbbabbabbbbbb
bbabbbbbabbbbbbabbbbabbbbbbabbbbbbabbbbbbbbbbbbabb
bbbbbbbbbbbbbbbbbbbbbbbbabbbbbbbabbbbbbabbbbbbbbba
bbbbabbbbbbbbabbabbbbbbbbbbbabbbbabbbbbbbbabbbbbbb
bbbbbbbabbbbbbbbbbbbabbbbbbbbbabbbbbbabbbbbbbabbbb
babbbbbbbbbbabbbbbbbbbabbcbcbbbbbbbbbbbbbabbbbbbab
bbbbbbabbbbbbbbabbbbbbbbcccccbbbbbbbbabbbbbbabbbbb
bbbbbbbbbbabbbbbbbabbbbbcccdccbabbbbbbabbbbbbbbbbb
bbbbabbbbbbbbbabbbbbbabccceeeccbbbbbabbbbbbbabbabb
bbbbbbbbbbabbbbbbabbbccccceeecbbbbbbbbbbbbbbbbbbbb
bbbbbbbbbbbbbbbabbbbbccccceeecbccbbcbbbbbbbbabbbbb
abbbbbbabbbbbbbbbbbbcccccccccccccccccbbbbabbbbbbbb
bbbabbbbbbbbabbbbabcccccccccccfccccbbbbbbbbbbbbabb
bbbbbbabbbbbbbbbbbbbghhijcccccfcckcbbabbbbbbabbbba
bbbbbbbbbbabbbbbabbbfcccccclccmnopcbbbbbbabbbbbbab
bbbbbabbbbbbqbbbbbbgrccccsccccccccccbbbbbbbbbbbbbb
bbbbbbbbbbtbbbbbbbbfuuuuuuuuuuuuuuucbabbbbbbbbabba
babbbbabbbbbbbabbvwxuuuuuuuuuuuuuuubbbbbabbbbbbbbb
bbbbbbbbbbuuuubbufuuuuuuuuuuuuuuuuubbbbbbbbbbabbbb
bbbbbbbbbbucyubbufccghhzAuuuuuuuuuubbbbabbbbbbbbab
bbbbbbbbbbuccubbuBccCghDkuuuuuuuuuubbbbbbbbabbbbbb
bbbbbbbbbbcccubbufcEfFckkuuuuuuuuuubbabbbbbbbbbabb
bbbGbbbbbHuccuuuucccffckkuuuuuuuuuubbbbbbbbabbbbbb
bbbbbbbbbIucccccccccfmJpKuuuuuuuuuubbbbbbbbbbbbbab
bbbbbbbbbLuuccccccccmMoopuuuuuuuuuubbbbbabbbbbbbbb
bbbbbbbbbbbuuuuuNOPuuuuuuuuuuuuuuuubbbbbbbbbbbabbb
bbbbbbbbbbbbbbbbbbbbuuuuuuuuuuuuuuubbabbbbbbbbbbbb
"}

(1,1,2) = {"
uuuuuuuuuuuuuuuuuuuuuuuuuuuuuuuuuuuuuuuuuuuuuuuuuu
uuuuuuuuuuuuuuuuuuuuuuuuuuuuuuuuuuuuuuuuuuuuuuuuuu
uuuuuuuuuuuuuuuuuuuuuuuuuuuuuuuuuuuuuuuuuuuuuuuuuu
uuuuuuuuuuuuuuuuuuuuuuuuuuuuuuuuuuuuuuuuuuuuuuuuuu
uuuuuuuuuuuuuuuuuuuuuuuuuuuuuuuuuuuuuuuuuuuuuuuuuu
uuuuuuuuuuuuuuuuuuuuuuuuuuuuuuuuuuuuuuuuuuuuuuuuuu
uuuuuuuuuuuuuuuuuuuuuuuuuuuuuuuuuuuuuuuuuuuuuuuuuu
uuuuuuuuuuuuuuuuuuuuuuuuuuuuuuuuuuuuuuuuuuuuuuuuuu
uuuuuuuuuuuuuuuuuuuuuuuuuuuuuuuuuuuuuuuuuuuuuuuuuu
uuuuuuuuuuuuuuuuuuuuuuuuuuuuuuuuuuuuuuuuuuuuuuuuuu
uuuuuuuuuuuuuuuuuuuuuuuuuuuuuuuuuuuuuuuuuuuuuuuuuu
uuuuuuuuuuuuuuuuuuuuuuuuuuuuuuuuuuuuuuuuuuuuuuuuuu
uuuuuuuuuuuuuuuuuuuuuuuuuuuuuuuuuuuuuuuuuuuuuuuuuu
uuuuuuuuuuuuuuuuuuuuuuuuuuuuuuuuuuuuuuuuuuuuuuuuuu
uuuuuuuuuuuuuuuuuuuuuuuuuuuuuuuuuuuuuuuuuuuuuuuuuu
uuuuuuuuuuuuuuuuuuuuuuuuuuuuuuuuuuuuuuuuuuuuuuuuuu
uuuuuuuuuuuuuuuuuuuuuuuuuuuuuuuuuuuuuuuuuuuuuuuuuu
uuuuuuuuuuuuuuuuuuuuuuuuuuuuuuuuuuuuuuuuuuuuuuuuuu
uuuuuuuuuuuuuuuuuuuuuuuuuuuuuuuuuuuuuuuuuuuuuuuuuu
uuuuuuuuuuuuuuuuuuuuuuuuuuuuuuuuuuuuuuuuuuuuuuuuuu
uuuuuuuuuuuuuuuuuuuuuuuuuuuuuuuuuuuuuuuuuuuuuuuuuu
uuuuuuuuuuuuuuuuuuuuuuuuuuuuuuuuuuuuuuuuuuuuuuuuuu
uuuuuuuuuuuuuuuuuuuuuuuuuuuuuuuuuuuuuuuuuuuuuuuuuu
uuuuuuuuuuuuuuuuuuuuuuuuuuuuuuuuuuuuuuuuuuuuuuuuuu
uuuuuuuuuuuuuuuuuuuuuuuuuuuuuuuuuuuuuuuuuuuuuuuuuu
uuuuuuuuuuuuuuuuuuuuuuuuuuuuuuuuuuuuuuuuuuuuuuuuuu
uuuuuuuuuuuuuuuuuuuuuuuuuuuuuuuuuuuuuuuuuuuuuuuuuu
uuuuuuuuuuuuuuuuuuuuuuuuuuuuuuuuuuuuuuuuuuuuuuuuuu
uuuuuuuuuuuuuuuuuuuuuuuuucccccuuuuuuuuuuuuuuuuuuuu
uuuuuuuuuuuuuuuuuuuuuuuuucccccuuuuuuuuuuuuuuuuuuuu
uuuuuuuuuuuuuuuuuuuuuuuuuccQccuuuuuuuuuuuuuuuuuuuu
uuuuuuuuuuuuuuuuuuuuuuuuucRRRcuuuuuuuuuuuuuuuuuuuu
uuuuuuuuuuuuuuuuuuuuuuuuucRRRcuuuuuuuuuuuuuuuuuuuu
uuuuuuuuuuuuuuuuuuuuuuuuucRRRcuuuuuuuuuuuuuuuuuuuu
uuuuuuuuuuuuuuuuuuuuuuuuucccccuuuuuuuuuuuuuuuuuuuu
uuuuuuuuuuuuuuuuuuuuuuuuucSSScuuuuuuuuuuuuuuuuuuuu
uuuuuuuuuuuuuuuuuuuuuuuuuccccfuuuuuuuuuuuuuuuuuuuu
uuuuuuuuuuuuuuuuuuuuuuuuuccTcfuuuuuuuuuuuuuuuuuuuu
uuuuuuuuuuuuuuuuuuuuuuuuuEcccBuuuuuuuuuuuuuuuuuuuu
uuuuuuuuuuuuuuuuuuuuuuuuucclcfuuuuuuuuuuuuuuuuuuuu
uuuuuuuuuuuuuuuuuuuuuuuuuscUccuuuuuuuuuuuuuuuuuuuu
uuuuuuuuuuuuuuuuuuuuuuuuuuuuuuuuuuuuuuuuuuuuuuuuuu
uuuuuuuuuuuuuuuuuuuuuuuuuuuuuuuuuuuuuuuuuuuuuuuuuu
uuuuuuuuuuuuuuuuuuuuuuuuuuuuuuuuuuuuuuuuuuuuuuuuuu
uuuuuuuuuuuuuuuuuuuuuuuuuuuuuuuuuuuuuuuuuuuuuuuuuu
uuuuuuuuuuuuuuuuuuuuuuuuuuuuuuuuuuuuuuuuuuuuuuuuuu
uuuuuuuuuuuuuuuuuuuuuuuuuuuuuuuuuuuuuuuuuuuuuuuuuu
uuuuuuuuuuuuuuuuuuuuuuuuuuuuuuuuuuuuuuuuuuuuuuuuuu
uuuuuuuuuuuuuuuuuuuuuuuuuuuuuuuuuuuuuuuuuuuuuuuuuu
uuuuuuuuuuuuuuuuuuuuuuuuuuuuuuuuuuuuuuuuuuuuuuuuuu
"}

(1,1,3) = {"
uuuuuuuuuuuuuuuuuuuuuuuuuuuuuuuuuuuuuuuuuuuuuuuuuu
uuuuuuuuuuuuuuuuuuuuuuuuuuuuuuuuuuuuuuuuuuuuuuuuuu
uuuuuuuuuuuuuuuuuuuuuuuuuuuuuuuuuuuuuuuuuuuuuuuuuu
uuuuuuuuuuuuuuuuuuuuuuuuuuuuuuuuuuuuuuuuuuuuuuuuuu
uuuuuuuuuuuuuuuuuuuuuuuuuuuuuuuuuuuuuuuuuuuuuuuuuu
uuuuuuuuuuuuuuuuuuuuuuuuuuuuuuuuuuuuuuuuuuuuuuuuuu
uuuuuuuuuuuuuuuuuuuuuuuuuuuuuuuuuuuuuuuuuuuuuuuuuu
uuuuuuuuuuuuuuuuuuuuuuuuuuuuuuuuuuuuuuuuuuuuuuuuuu
uuuuuuuuuuuuuuuuuuuuuuuuuuuuuuuuuuuuuuuuuuuuuuuuuu
uuuuuuuuuuuuuuuuuuuuuuuuuuuuuuuuuuuuuuuuuuuuuuuuuu
uuuuuuuuuuuuuuuuuuuuuuuuuuuuuuuuuuuuuuuuuuuuuuuuuu
uuuuuuuuuuuuuuuuuuuuuuuuuuuuuuuuuuuuuuuuuuuuuuuuuu
uuuuuuuuuuuuuuuuuuuuuuuuuuuuuuuuuuuuuuuuuuuuuuuuuu
uuuuuuuuuuuuuuuuuuuuuuuuuuuuuuuuuuuuuuuuuuuuuuuuuu
uuuuuuuuuuuuuuuuuuuuuuuuuuuuuuuuuuuuuuuuuuuuuuuuuu
uuuuuuuuuuuuuuuuuuuuuuuuuuuuuuuuuuuuuuuuuuuuuuuuuu
uuuuuuuuuuuuuuuuuuuuuuuuuuuuuuuuuuuuuuuuuuuuuuuuuu
uuuuuuuuuuuuuuuuuuuuuuuuuuuuuuuuuuuuuuuuuuuuuuuuuu
uuuuuuuuuuuuuuuuuuuuuuuuuuuuuuuuuuuuuuuuuuuuuuuuuu
uuuuuuuuuuuuuuuuuuuuuuuuuuuuuuuuuuuuuuuuuuuuuuuuuu
uuuuuuuuuuuuuuuuuuuuuuuuuuuuuuuuuuuuuuuuuuuuuuuuuu
uuuuuuuuuuuuuuuuuuuuuuuuuuuuuuuuuuuuuuuuuuuuuuuuuu
uuuuuuuuuuuuuuuuuuuuuuuuuuuuuuuuuuuuuuuuuuuuuuuuuu
uuuuuuuuuuuuuuuuuuuuuuuuuuuuuuuuuuuuuuuuuuuuuuuuuu
uuuuuuuuuuuuuuuuuuuuuuuuuuuuuuuuuuuuuuuuuuuuuuuuuu
uuuuuuuuuuuuuuuuuuuuuuuuuuuuuuuuuuuuuuuuuuuuuuuuuu
uuuuuuuuuuuuuuuuuuuuuuuuuuuuuuuuuuuuuuuuuuuuuuuuuu
uuuuuuuuuuuuuuuuuuuuuuuuuuuuuuuuuuuuuuuuuuuuuuuuuu
uuuuuuuuuuuuuuuuuuuuuuuuuuuuuuuuuuuuuuuuuuuuuuuuuu
uuuuuuuuuuuuuuuuuuuuuuuuuuuuuuuuuuuuuuuuuuuuuuuuuu
uuuuuuuuuuuuuuuuuuuuuuuuuuuuuuuuuuuuuuuuuuuuuuuuuu
uuuuuuuuuuuuuuuuuuuuuuuuuuuuuuuuuuuuuuuuuuuuuuuuuu
uuuuuuuuuuuuuuuuuuuuuuuuuuuuuuuuuuuuuuuuuuuuuuuuuu
uuuuuuuuuuuuuuuuuuuuuuuuuuuuuuuuuuuuuuuuuuuuuuuuuu
uuuuuuuuuuuuuuuuuuuuuuuuuuuuuuuuuuuuuuuuuuuuuuuuuu
uuuuuuuuuuuuuuuuuuuuuuuuucccccuuuuuuuuuuuuuuuuuuuu
uuuuuuuuuuuuuuuuuuuuuuuuucccccuuuuuuuuuuuuuuuuuuuu
uuuuuuuuuuuuuuuuuuuuuuuuucccccuuuuuuuuuuuuuuuuuuuu
uuuuuuuuuuuuuuuuuuuuuuuuucccccuuuuuuuuuuuuuuuuuuuu
uuuuuuuuuuuuuuuuuuuuuuuuuccTccuuuuuuuuuuuuuuuuuuuu
uuuuuuuuuuuuuuuuuuuuuuuuucccccuuuuuuuuuuuuuuuuuuuu
uuuuuuuuuuuuuuuuuuuuuuuuuuuuuuuuuuuuuuuuuuuuuuuuuu
uuuuuuuuuuuuuuuuuuuuuuuuuuuuuuuuuuuuuuuuuuuuuuuuuu
uuuuuuuuuuuuuuuuuuuuuuuuuuuuuuuuuuuuuuuuuuuuuuuuuu
uuuuuuuuuuuuuuuuuuuuuuuuuuuuuuuuuuuuuuuuuuuuuuuuuu
uuuuuuuuuuuuuuuuuuuuuuuuuuuuuuuuuuuuuuuuuuuuuuuuuu
uuuuuuuuuuuuuuuuuuuuuuuuuuuuuuuuuuuuuuuuuuuuuuuuuu
uuuuuuuuuuuuuuuuuuuuuuuuuuuuuuuuuuuuuuuuuuuuuuuuuu
uuuuuuuuuuuuuuuuuuuuuuuuuuuuuuuuuuuuuuuuuuuuuuuuuu
uuuuuuuuuuuuuuuuuuuuuuuuuuuuuuuuuuuuuuuuuuuuuuuuuu
"}
